40
40

11 11 11 11 11 11 11 11 11 11 11 11 11 11 11 11 11 11 11 11 11 11 11 11 11 11 11 11 11 11 11 11 11 11 11 11 11 11 11 11 
11 11 11 11 11 11 11 11 11 11 11 11 11 11 11 11 11 11 11 11 11 11 11 11 11 11 11 11 11 11 11 11 11 11 11 11 11 11 11 11
21 21 34 11 11 11 11 11 11 11 11 11 11 11 11 11 11 11 11 11 11 11 11 11 11 11 11 11 11 11 11 11 11 11 11 11 11 11 11 11
21 21 21 34 11 11 11 11 11 11 11 11 11 11 11 11 11 11 11 11 11 11 11 11 11 11 33 21 21 21 21 21 34 11 11 11 11 11 11 11
21 21 21 21 34 11 11 11 11 11 33 21 21 21 21 21 21 21 21 21 34 11 11 11 11 33 21 21 21 21 21 21 21 34 11 11 11 11 11 11
21 21 21 21 21 11 11 11 11 33 21 21 21 21 21 21 21 21 21 21 21 34 11 11 11 21 21 21 21 21 21 21 21 21 11 11 11 11 11 11
11 31 21 21 21 11 11 11 33 21 21 21 21 21 21 21 21 21 21 21 21 21 34 11 11 21 21 21 32 11 31 21 21 21 11 11 11 11 11 11
11 11 21 21 21 11 11 33 21 21 21 32 11 11 11 11 11 11 31 21 21 21 21 11 11 21 21 21 11 11 11 21 21 21 11 11 11 11 11 11
11 11 21 21 21 11 11 21 21 21 32 11 11 11 11 11 11 11 11 31 21 21 21 11 11 21 21 21 11 11 11 21 21 21 11 11 11 11 11 11
11 11 21 21 21 11 11 21 21 21 11 11 11 11 11 11 11 11 11 33 21 21 21 11 11 21 21 21 11 11 11 21 21 21 34 11 11 11 11 11
11 11 21 21 21 11 11 21 21 21 11 11 11 11 11 11 11 11 33 21 21 21 21 11 11 21 21 21 11 11 11 21 21 21 21 34 11 11 11 11
11 11 21 21 21 11 11 21 21 21 11 11 11 11 11 11 11 33 21 21 21 21 32 11 11 21 21 21 11 11 11 31 21 21 21 21 34 11 11 11
11 11 21 21 21 11 11 21 21 21 11 11 11 11 11 11 33 21 21 21 21 32 11 11 11 21 21 21 11 11 11 11 31 21 21 21 21 34 11 11
11 11 21 21 21 11 11 21 21 21 11 11 11 11 11 11 21 21 21 21 32 11 11 11 11 21 21 21 11 11 11 11 11 31 21 21 21 21 11 11
11 11 21 21 21 11 11 21 21 21 11 11 11 11 11 11 21 21 21 32 11 11 11 11 11 21 21 21 11 11 11 11 11 11 31 21 21 21 11 11
11 11 21 21 21 11 11 21 21 21 11 11 11 11 11 11 21 21 21 11 11 11 11 11 33 21 21 21 11 11 11 11 11 11 11 21 21 21 11 11
11 11 21 21 21 11 11 21 21 21 11 11 11 11 11 11 21 21 21 34 11 11 11 33 21 21 21 32 11 11 11 11 11 11 33 21 21 21 11 11
11 11 21 21 21 11 11 21 21 21 34 11 11 11 11 11 21 21 21 21 34 11 33 21 21 21 32 11 11 11 11 11 11 33 21 21 21 21 11 11
11 11 21 21 21 11 11 21 21 21 21 34 11 11 11 11 31 21 21 21 21 21 21 21 21 32 11 11 11 11 11 11 33 21 21 21 21 32 11 11
11 11 21 21 21 11 11 31 21 21 21 21 11 11 11 11 11 31 21 21 21 21 21 21 32 11 11 11 11 11 11 33 21 21 21 21 32 11 11 11
11 11 21 21 21 11 11 11 31 21 21 21 11 11 11 11 11 11 31 21 21 21 21 32 11 11 11 11 11 11 33 21 21 21 21 32 11 11 11 11
11 11 21 21 21 11 11 11 11 21 21 21 11 11 11 11 11 11 11 11 11 11 11 11 11 11 11 33 21 21 21 21 21 21 32 11 11 11 11 11
11 11 21 21 21 11 11 11 11 21 21 21 11 11 11 11 11 11 11 11 11 11 11 11 11 33 21 21 21 21 21 21 21 32 11 11 11 11 11 11
11 11 21 21 21 11 11 11 11 21 21 21 11 11 11 11 11 11 11 11 11 11 11 33 21 21 21 21 21 21 21 21 32 11 11 11 11 11 11 11
11 11 21 21 21 11 11 11 11 21 21 21 11 11 11 11 11 11 11 11 11 33 21 21 21 21 21 32 11 11 11 11 11 11 11 11 11 11 11 11
11 11 21 21 21 11 11 11 11 21 21 21 34 11 11 11 11 11 11 33 21 21 21 21 21 32 11 11 11 11 11 11 11 11 11 11 11 11 11 11
11 11 21 21 21 11 11 11 11 21 21 21 21 34 11 11 11 11 33 21 21 21 21 32 11 11 11 11 11 11 11 11 11 33 21 21 34 11 11 11
11 11 21 21 21 11 11 11 11 31 21 21 21 21 34 11 11 33 21 21 21 32 11 11 11 11 11 11 11 11 11 11 33 21 21 21 21 34 11 11
11 11 21 21 21 11 11 11 11 11 31 21 21 21 21 11 11 21 21 21 32 11 11 11 11 11 11 11 33 21 21 21 21 21 21 21 21 21 11 11
11 11 21 21 21 11 11 11 11 11 11 31 21 21 21 11 11 21 21 21 11 11 11 11 11 11 11 33 21 21 21 21 21 21 21 21 21 21 11 11
11 11 21 21 21 11 11 11 11 11 11 11 21 21 21 11 11 21 21 21 11 11 11 11 11 11 33 21 21 21 21 21 21 21 21 21 21 21 11 11
11 11 21 21 21 11 11 11 11 11 11 11 21 21 21 11 11 21 21 21 11 11 11 11 11 11 21 21 21 32 11 11 31 21 21 21 21 32 11 11
11 11 21 21 21 34 11 11 11 11 11 33 21 21 21 11 11 21 21 21 34 11 11 11 11 33 21 21 32 11 11 11 11 31 21 21 32 11 11 11
11 11 31 21 21 21 34 11 11 11 33 21 21 21 32 11 11 21 21 21 21 34 11 11 33 21 21 21 11 11 11 11 11 11 11 11 11 11 11 11
11 11 11 31 21 21 21 21 21 21 21 21 21 32 11 11 11 31 21 21 21 21 21 21 21 21 21 32 11 11 11 11 11 11 11 11 11 11 11 11
11 11 11 11 31 21 21 21 21 21 21 21 32 11 11 11 11 11 31 21 21 21 21 21 21 21 32 11 11 11 11 11 11 11 11 11 11 11 11 11
11 11 11 11 11 31 21 21 21 21 21 32 11 11 11 11 11 11 11 31 21 21 21 21 21 32 11 11 11 11 11 11 11 11 11 11 11 11 11 11
11 11 11 11 11 11 11 11 11 11 11 11 11 11 11 11 11 11 11 11 11 11 11 11 11 11 11 11 11 11 11 11 11 11 11 11 11 11 11 11
11 11 11 11 11 11 11 11 11 11 11 11 11 11 11 11 11 11 11 11 11 11 11 11 11 11 11 11 11 11 11 11 11 11 11 11 11 11 11 11
11 11 11 11 11 11 11 11 11 11 11 11 11 11 11 11 11 11 11 11 11 11 11 11 11 11 11 11 11 11 11 11 11 11 11 11 11 11 11 11