25
25

11 11 11 11 11 11 11 11 11 11 11 11 11 11 11 11 11 11 11 11 11 11 11 11 11
11 11 11 11 11 11 11 11 11 11 11 11 11 11 11 11 11 11 11 11 11 11 11 11 11
21 21 21 21 21 21 21 21 11 11 11 11 11 11 11 11 11 11 11 11 11 11 11 11 11
11 11 11 11 11 11 11 21 21 11 11 11 11 11 11 11 11 11 11 11 11 11 11 11 11
11 11 11 11 11 11 11 11 21 11 11 11 11 11 21 21 21 21 11 11 11 11 11 11 11
11 11 11 11 11 11 11 11 21 11 11 11 11 21 21 11 11 21 21 11 11 11 11 11 11
11 11 11 11 11 11 11 21 21 11 11 11 21 21 11 11 11 11 21 21 11 11 11 11 11
11 11 11 11 11 21 21 21 11 11 11 21 21 11 11 11 11 11 11 21 21 11 11 11 11
11 11 11 11 21 21 11 11 11 11 11 21 11 11 11 11 11 11 11 11 21 21 11 11 11
11 11 11 11 21 11 11 11 11 11 11 21 11 11 11 11 11 11 11 11 11 21 11 11 11
11 11 11 11 21 11 11 11 11 11 11 21 21 11 11 11 11 11 11 11 11 21 11 11 11
11 11 11 11 21 11 11 11 11 11 11 11 21 21 11 11 11 11 11 11 11 21 11 11 11
11 11 11 11 21 11 11 11 11 11 11 11 11 21 11 11 11 11 11 11 11 21 11 11 11
11 11 11 11 21 11 11 11 11 11 11 11 11 21 11 11 11 11 11 11 11 21 11 11 11
11 11 11 11 21 11 11 11 11 11 11 11 11 21 11 11 11 11 11 11 21 21 11 11 11
11 11 11 11 21 21 11 11 11 11 11 11 11 21 11 11 11 11 11 21 21 11 11 11 11
11 11 11 11 11 21 21 11 11 11 11 11 21 21 11 11 11 11 21 21 11 11 11 11 11
11 11 11 11 11 11 21 21 11 11 11 21 21 11 11 11 11 21 21 11 11 11 11 11 11
11 11 11 11 11 11 11 21 21 21 21 21 11 11 11 11 11 21 11 11 11 11 11 11 11
11 11 11 11 11 11 11 11 11 11 11 11 11 11 11 11 21 21 21 11 11 11 11 11 11
11 11 11 11 11 11 11 11 11 11 11 11 11 11 11 21 99 21 21 21 11 11 11 11 11
11 11 11 11 11 11 11 11 11 11 11 11 11 11 11 21 21 21 21 21 11 11 11 11 11
11 11 11 11 11 11 11 11 11 11 11 11 11 11 11 21 21 21 21 21 11 11 11 11 11
11 11 11 11 11 11 11 11 11 11 11 11 11 11 11 11 21 21 21 11 11 11 11 11 11
11 11 11 11 11 11 11 11 11 11 11 11 11 11 11 11 11 11 11 11 11 11 11 11 11
